111111111211111
121111111111111
111111111111111
111112111111111
111111111222111
111211111111111
111211111111111
111211111111111
111211111111111
111211111112111
111211111112111
111111111112111
111111111112111
111111111112111
111111111112111
111222111111111
111111111211111
111111111111111
111111111111121
111112111111111
