111111211211111
111111111211111
111111111211111
211111111211111
111111111221111
111111111211111
111222222111111
111111111111112
111111111111111
111111111111111
211111111221111
111111111211111
111111111211111
111111111122211
111111111211111
111111111211111
111211111211111
111121111111111
111112111111111
111111111111111