111111111111111
111121111111111
111111111111111
111111121111111
111111111111111
111111111111121
111111111111111
111122222211111
111122222211111
111111111111111
111111111111111
111111111111111
222111111111111
111111111111111
111111112111111
111111112111111
111111112111111
111111111111211
111111111111111
111111111111111
