111111121111111
111111111111111
111111111111111
222211111111111
111211122211111
111111121111111
111111121111111
111111121111111
111111121111111
211111121111222
211111111111111
211111111111111
111111111111111
111111111222222
111111111111111
111121111111111
111112111111111
111111211111111
111111121111111
111111111111111